


NO textures/simonkraft/bookshelf.xpm
SO textures/simonkraft/bookshelf_01.xpm
WE textures/simonkraft/bookshelf_02.xpm
EA textures/simonkraft/bookshelf_03.xpm


F 139,99,58
C 171,154,137

        1111111111111111111111111
        1000000000110000000000001
        1011000001110000000000001
        1001000000000000000000001
111111111011000001110000000000001
100000000011000001110111111111111
11110111111111011100000010000000011
111101111111110111010100100000000001
1100000011010101110000000000000000001
100000000000000011000000001000000011
10000000000000011010100100000000001
11000001110101011111011110N01111111
11110111 1110101 101111010001
11111111 1111111 111111111111