F 164,169,20
C 153,204,255

NO textures/simonkraft/wet_sponge.xpm
SO textures/simonkraft/wet_sponge.xpm
WE textures/simonkraft/wet_sponge.xpm
EA textures/simonkraft/wet_sponge.xpm

111111111111111111111
1C100000100000C000001
101010101011111110001
100010100010000010001
111110101111101011101
100000101000101000K01
101111101011101111111
101000001010100D00101
101011111010111110101
1010A001010100010101
101110101010101010101
100000101H10C01010001
111111101011111011101
1C0000101001000100001
101110101110101110111
1010001C000C001010101
101011111111111010201
1N00010000X0000010001
101010111011111111101
111100000100000000H01
111111111111111111111

