F 200,100,50
C 50,100,200

NO textures/simonkraft/wet_sponge.xpm
SO textures/simonkraft/wet_sponge.xpm
WE textures/simonkraft/wet_sponge.xpm
EA textures/simonkraft/wet_sponge.xpm

11111111111111111
1C000011X0000C001
1011101000101110101
100000000000000001
111111011101111111
1H000C00000C000H1
1001110111011100001
1000000000000000X1
1111011111110111111
1C00000000000000C1
1001111111111110001
1X00000K00000X001
1001111111111110001
1000000NA0000D001
1111111111111111111
