F 255,100,100
C 100,255,100

NO textures/simonkraft/cobblestone.xpm
SO textures/simonkraft/cobblestone_01.xpm
WE textures/simonkraft/mossy_cobblestone1.xpm
EA textures/simonkraft/cobblestone_02.xpm

111111111111111111111
1000000000000000H001
1011111101111110111101
100000000000000000C01
1111111011111101111101
1C0000001000000100001
1011101111011101111101
100000000000000000001
1111101111111111110111
1H00000000000000000001
1011111111111111101111
100000000000000000001
1111111111111111111211
1C00000000000000C00201
1011111111111111101111
10000000K000000H000X1
1011111111111111111011
1N00000000000000000001
1111111111D11111111111
111111111111111111111
