F 128,128,128
C 64,64,64

NO textures/simonkraft/cobblestone.xpm
SO textures/simonkraft/cobblestone_01.xpm
WE textures/simonkraft/mossy_cobblestone1.xpm
EA textures/simonkraft/cobblestone_02.xpm

1111111111111
1C00000000001
1000111110001
1000100010001
1H00100010001
1000100010C01
1000100010001
1000111110001
1000000000001
1000000K0ND01
1111111111111
